####################
#..................#
#.....A............#
#.........#........#
#.........#........#
#.........#........#
#.........#........#
....E.....#....E....
..........#.........
...##############...
..........#.........
..........#.........
.....E....#.....E...
#.........#........#
#.........#........#
#.........#........#
#.........#........#
#..................#
#..................#
####################