####################
#..................#
#..................#
#..A......#........#
#.........#........#
#.........#........#
#.........#........#
#...E.....#....E...#
#.........#........#
#..##############..X
#.........#........#
#.........#........#
#....E....#.....E..#
#.........#........#
#.........#........#
#.........#........#
#.........#........#
#..................#
#..................#
#..................#
####################