####################
#..................#
#..................#
#.........#........#
#.........#........#
#.........#........#
#.........#........#
....E.....#....E....
..........#.........
.A.##############...
..........#.........
..........#.........
.....E....#.....E...
#.........#........#
#.........#........#
#.........#........#
#.........#........#
#..................#
#..................#
#..................#
####################